20
20
++++++++++++++++++++
+OXXX+X^^X+^^^^+XXX+
+OOXO+^XX^+^O^O+X/X+
+OO*X+XXXX+OXOX+OXX+
+^OO^+XXXOXXXXX+XOX+
+XXOX+OXXX+OX  +XXX+
+  XX+XOXO+^O  +XOO+
+XXXX+XOXX+XXOX+XOO+
+    +OXXO+XXXX+XOO+
+!  !+XXXX+   !+XXO+
+    +XOXX+XXXX+XOX+
+XXXX+OXOX+!   +OXX+
+O^^O+XXXX+XXXX+XXO+
+OXXO+XO^^+   !+XOX+
+XXXX+XXO^+XXXX+XOO+
+X  XXXXXO+XXXXXXXX+
+!XX +XXXX+XXXX+XOX+
+XOOX+ !! +X^^X+OXX+
+^XX^+^^^^+^++^+XXX+
++++++++++++++++++++