20
20
++++++++++++++++++++
+OXOX+XXXX+  !+ OO +
+X*XO+X^^XX   +OXXO+
+XXXX+X^^X+   XXXXX+
+XXXX+XXXX+!  +XOOX+
+++X+++X+++++++ XX +
+XOXO+XXO^+XOO+ XX +
+OXXO+X XX+XOXXXOOX+
+XXXXX XX +^XX+ XX +
+XXXX+X X^+^^X+X  X+
+++++++X++++++++X+++
+^XX^+!  !+ X +XXOO+
+X  XX XX +X^XXX XX+
+^XX^+ !  + X + XX^+
++X+++ XX +X++++++++
+XXX^+ !  +OXO+OXXO+
+XX^X+ XX +X X+X /X+
+X^XX+  ! +X XXX  X+
+^XXX+!  !+OXO+OXXO+
++++++++++++++++++++