20
20
++++++++++++++++++++
+!O!+!   !XXOXXX!  +
+OOX+     XXOOXX   +
+XX*+^   ^X^XXXX  ^+
+XXX+XXX++++++++XX^+
+XXX+XOX+XXXOXO+X O+
+   +XOX+X^XXOO+XXX+
+   +XXX+XXXXXX+X  +
+  !+XX^+  +XXX+XXX+
+XXO+XXO+XX+O^O+XOX+
+X ^+XXX+/X+XXX+ XO+
+XXX+XXX++++XXX+ XX+
+OXX+XOXXX^ XXX+ OX+
+XXX+OXXOXXX^XO+OXX+
+XX +XO^XX  X ^+X  +
+XXX++++++++++++XXX+
+OXXXXXXXO^XXOXX   +
+XOXX^XXX^OXO^ X   +
+^XXXOXXXX^XXXXX !^+
++++++++++++++++++++