20
20
++++++++++++++++++++
+XOOX ^+O^^O+^OOOO^+
+X*XX !+^OO^+XXXXXX+
+XXXXXX+XXXX+OX^^XO+
+XOXX  +XXXX+OX^^XO+
+^XOXXOXX  XXXXXXXX+
+XXXXXXX X XXX   !^+
+++++OX++OO++XX+++++
+ OXXXX+^OO^+X XXO^+
+OXOXXXOO^^OO XXOXO+
+X^X   XX^^OO XXOXO+
+XXX ! +^OO^+XOXXXX+
+++++XX++XX++XX+++++
+!   XXX    XXX X X+
+  ^ !XX  ! XXOXOX X
+  XX  +XXXX+ X X X+
+ !XX  +XXXX+XOXOXO+
+      +X^^X+ X X X+
+ ^ ^ ^+^OO^+X XO/ +
++++++++++++++++++++