++++++++++++++++++++
+XXXX--OXXXXOXXXXX^+
+-XXX-!XXO--XO^OXXX+
+XO*OXXXOXXXXOOO-XX+
+OXXXXXXXOX-XXOXOXX+
+XO^X-X^XX--XXXXXXX+
+OXXX-XOXXXX-XOX^XX+
+++++++++++++XX-XXX+
+XXXXX!XXXO^XXXX---+
+-^-OX--XXXXXXXX---+
+X-XXOXXXXXOOOXX-!-+
+XXXXXOXX--X^XXXX^X+
+XXX-^XX^-!-X--XXXX+
+XXXXXX+++++++++++++
+---XXOX^OXXXXXXXO/+
+-!-XXXOXXX-XXXXOXX+
+-^-XX^XOXXXX-XX^XX+
+XXXXXXXXXXXX-XXXXX+
+-XXXXX---!^XXX--XX+
++++++++++++++++++++